// 100 50
####################################################################################################
##########))))))))##-----W....######################################################################
##########))))))))##-----####......#################################################################
##########))))#W############..####.#################################################################
#(((((((#######&&&#^^^######W#####W###########00000000##############################################
#(((((((##&&&&&&&&#^^^#####%%%%#$$$$$........W00000000##############################################
#(((((((W&&&&&&&&&W^^^....W%%%%#$$$$$#########00000000##############################################
#(((((###&&&&&&&&&#^^^#####%%%%#$$$$$##########0000000##############################################
###############W##################B############0000000##############################################
##########********##22222#######11111############...##########33333#######44444#####################
###########********#22222#######11111#############.###########33333#######44444#####################
##############G#####22222#######11111#############.###########33333#######44444#####################
##############.#######R###########W###############W#############G###########B#######################
##############...................................................................###################
############################.#############.###############.#############.###########################
############################.#############.###############.#############.###########################
############################B#############G###############W#############R###########################
############################.#############.###############.#############.###########################
######################55555#.#######77777#.###############.#88888#######.#99999#####################
######################55555W.#######77777R.###############.B88888#######.G99999#####################
######################55555#.#######77777#.###############.#88888#######.#99999#####################
############################.#############.###############.#############.###########################
############################.............................................###########################
############################.#################B###W###G#################.###########################
######################66666#.###############@@@@@#.#~~~~~###############.#!!!!!#####################
######################66666G.###############@@@@@#.#~~~~~###############.W.!!!!#####################
######################66666#################@@@@@#.#~~~~~#################!!!!!#####################
##################################################.#################################################
##################################################.#################################################
##################################################.#################################################
####################################################################################################
####################################################################################################
####################################################################################################
####################################################################################################
####################################################################################################
####################################################################################################
####################################################################################################
####################################################################################################
####################################################################################################
####################################################################################################
####################################################################################################
####################################################################################################
####################################################################################################
####################################################################################################
####################################################################################################
####################################################################################################
####################################################################################################
####################################################################################################
####################################################################################################
####################################################################################################
