// 37 50
#####################################
#----####}}##########################
#----H...}}###############.#[[[[[####
#----#####################.R[[[[[####
##.....###############111#.#[[[[[####
#####..########~~~~~##111#.###.######
######.########~~~~~##111#.###R######
#@@@@#........G~~~~~###....W]]]]]####
#@@@@#.##########G#####.####]]]]]####
#@@@@#.####22222#.#####W####]]]]]####
##R###.####22222B.###33333###########
#4444#.#######.##...G33333###########
#4444W.#######.####.#33333B(((((#####
#4444#########.###..####.##(((((#####
#W############B####....B.G.(((((#####
#.#########0000000######W##G###W#####
#.#5555####0000000####66666.###.#####
#.#5555####0000000####66666##))))####
#.R5555...R0000000W...66666R)))))####
#.#5555####0000000####66666#)))))####
#.#5555####0000000####66666###W######
#.#########0000000####B#######..#####
#.##########W#G#####$$$$$######.#####
#............#.#####$$$$$#####..#####
#.#######.####.#####$$$$$B.....######
#.###77777####.#####$$$$$####..######
#.###77777#8888888###########.#######
#.###77777#8888888#9999999###B#######
#.#########8888888#9999999###.#######
#.############G####9999999W.....#####
#.############.####9999999#####.#####
#.!!!!!#######.####9999999#####.#####
#.!!!!!............9999999......#####
####.#######R#########B########G#####
####.#######.#########.########.#####
####....####.#########....#####.#####
#######.##...############.###...#####
#######.##.##############.###.#######
##......##.#########......###.#######
##.#######......####.########......##
##.############.####.#############.##
##.....{{{{{###.####....##########.##
#####.#{{{{{#...#######.#######....##
#####W#######.#########.#######.#####
###*****###%%%%%#####^^^^^####&&&&&##
###*****###%%%%%#####^^^^^####&&&&&##
###*****###%%%%%#####^^^^^####&&&&&##
#####################################
#####################################
#####################################
