// 75 75
###########################################################################
###########################################################################
###########################################################################
###########################################################################
###########################################################################
###########################################################################
###########################################################################
###########################################################################
###########################################################################
###########################################################################
###########################################################################
###########################################################################
###########################################################################
###########################################################################
###########################################################################
#############################################.#############################
#############################################.#############################
###########################################ooooo############################
###########################################oooooo##########################
###########################################oooooo##########################
##########################################ooooooooo########################
##########################################ooooooooo########################
##########################################ooooooooo########################
##########################################ooooooooo########################
###########################################oooooo##########################
##############################################W###########eeee#############
##############################################.##..#####eeeeeeee###########
##############################################.........Weeeeeeee###########
########################################################eeeeeeeeW.#########
#########################################################eeeee###...#######
###########################################################..######.#######
###########################################################..######.#######
###########################################################..####pppppp####
##############################################.....BqqqqqqW.######ppppp####
##############################################.#####qqqqqq#.#####ppppp#####
##############################################.######qqqqq#.###############
#############################################..#####qqqqq##.###############
#########################################......#######W####R###############
#########################################.############.#$$$$$$$############
######################################~~~~############.#$$$$$$$#^^^^^######
###############################.......~~~~############.#$$$$$$$#^^^^^######
###############################B######~~~~############.#####R###^^^^^######
###############################.#2222###B#############...W%%%%%G^^^^^######
###################wwwwww#..###.G2222##33333###******#####%%%%%############
##################wwwwwww.......#2222G333333W..******W....%%%%%B&&&&&######
###############..Wwwwwwww.#####.######333333###******#####%%%%%#&&&&&######
###############.###############R#----#R###.#################W###&&&&&######
###############.###############.#----#.###.#################.###&&&&&######
###############.############.....-----.##...################.##############
#############((((((R.........####----###.....##########ttt##.##############
############(((((((####################4444444########tttttttt#############
############(((((((####################4444444########tttttttt#############
##########..((((#######################4444444########tttttttt#############
##########.############################4444444#########ttt###W#############
########.....))))))####################4444444###############.#############
########.####))))))B.##################4444444###############.#############
########.####))))))#.##################4444444######yyyyy####.#####iiiii###
########.###########.#####################.#########yyyyy#rrrrrr###iiiii###
########.##gggg#####.#####################.#########yyyyyGrrrrrrR..iiiii###
########.W.ggggR..##.###############999##999##999##########rrrrr###########
########.##gggg##.##.###############9999999999999#############rr###########
########.########.##.###############999##999##999##############B###########
########.########R##.################R####B####G##############uuuuu########
#######hhhhh####...#.##############5555##!!!##6666############uuuuu########
#######hhhhhW...fffB.##############5555##!!!##6666############uuuuu########
#######hhhhh####fff################5555##!!!##6666###77777#################
################fff#################555#!!!!!#666####77777#################
################fff##################...!!!!!...#####77777#################
##########################################.##########77777#####888888######
##########################################.##########B#########888888######
###############################11111####00000####............G8888888######
###############################11111...W00000W.....######R######88888######
####################..#########11111####00000#######@@@@@@@#####88888######
#####################.###################000########@@@@@@@################
###########################################################################
